111111111
100000001
1P0C0E111
111111111