1111111111
1000000001
101100P001
1000001111
11E11000C1
1000001001
1111111111
