1111111111
10C000P001
1011000001
1000001111
11E1100001
1000011101
1111111111
