1111111111
1P00000001
1011000001
1000001111
11E11000C1
1000001001
1111111111
