111111111111111111111111111111111111111111111111111111111111111111111111111111111111111111111111111111
1111C0000000000000000000000000000000000000000000000000000000000000000000000000000000000000000000000001
111101111000000000000000000000000000000000000000000000000000000000000000000000000000000000000000000001
11110C1E1000000000000000000000000000000000000000000000000000000000000000000000000000000000000000000001
111010101000000000000000000000000000000000000000000000000000000000000000000000000000000000000000000001
11PC001C1000000000000000000000000000000000000000000000000000000000000000000000000000000000000000000001
111111111111111111111111111111111111111111111111111111111111111111111111111111111111111111111111111111