111111111111111111
100000000000000001
100000000000000001
100000000000000001
100000000000000001
100000000000000001
1P0C0E000000000111
111111111111111111